10
15
               
 ############# 
 #...........# 
 #...........# 
 #...........# 
 #####.......# 
     #.......# 
     #.......# 
     ######### 
               